111111111111111111111111111111111111111111111111111111111111111
1000000000000000000000000000000001C00000000000000000000000000C1
100000000000000000000000000000000100000000000000000000000000001
10000000CCCCCCCCCC000000000000000100000000000000000000000000001
11111111111111111111111111111111010P000000000000000000000000001
100000000000000000000000000000000000000000000000000000000000001
1000CCCCCCCCCCCCCC000000000000000100000000000000000000000000001
100000000000000000000000000000000100000000000000000000000000001
1000000000000000000000000000000001E00000000000000000000000000C1
111111111111111111111111111111111111111111111111111111111111111