11111111111111
100000000CE001
1000000P000001
11100000000011
11111111111111