11111111111111
100000P0000001
10000000000001
10000000000001
10000000000001
11111111111111
